largeur 10
hauteur 10
chateau1 0 0
chateau2 9 9

Map
0000000001
0100000000
0010000000
0001000000
0000000000
0000000000
0000000000
0000000000
0000000000
0000000001
