largeur:10
hauteur:10

Map
1000000001
0100000000
0010000000
0001000000
0000000000
0000000000
0000000000
0000000000
0000000000
0000000000